NO ./xpm_test/height1.xpm
SO ./xpm_test/height4.xpm
WE ./xpm_test/height2.xpm
EA ./xpm_test/height8.xpm

F 220,100,0
C 225,30,0


11111111111
11111111111
11000000011
11000000011
11000000011
11000N00011
11000000011
11000000011
11000000011
11111111111
11111111111